ðŸ“Œ Regular Visa Countries:

ðŸ“Œ Visa Not Required Countries:
AB - Abkhazia
NK - Nagorno-Karabakh
OS - South Ossetia
SW - Sahrawi Arab Democratic Republic
TA - Transnistria
VI - US Virgin Islands

ðŸ“Œ eVisa Countries:
AD - Andorra
AE - United Arab Emirates
AG - Antigua and Barbuda
AI - Anguilla
AL - Albania
AM - Armenia
AO - Angola
AQ - Antarctica
AR - Argentina
AS - American Samoa
AT - Austria
AU - Australia
AW - Aruba
AX - Aland Islands
AZ - Azerbaijan
BA - Bosnia and Herzegovina
BB - Barbados
BD - Bangladesh
BE - Belgium
BF - Burkina Faso
BG - Bulgaria
BH - Bahrain
BI - Burundi
BJ - Benin
BL - Saint Barthelemy
BM - Bermuda
BN - Brunei
BO - Bolivia
BQ - Bonaire
BR - Brazil
BS - Bahamas
BT - Bhutan
BV - Bouvet Island
BW - Botswana
BY - Belarus
BZ - Belize
CA - Canada
CC - Cocos (Keeling) Islands
CD - Congo, Democratic Republic of the
CH - Switzerland
CI - Cote d'Ivoire
CK - Cook Islands
CL - Chile
CM - Cameroon
CN - China
CO - Colombia
CP - Northern Cyprus
CR - Costa Rica
CV - Cape Verde
CW - Curacao
CX - Christmas Island
CY - Cyprus
CZ - Czech Republic
DE - Germany
DK - Denmark
DM - Dominica
DO - Dominican Republic
DZ - Algeria
EC - Ecuador
EE - Estonia
EG - Egypt
EH - Western Sahara
ES - Spain
ET - Ethiopia
FI - Finland
FJ - Fiji
FK - Falkland Islands (Islas Malvinas)
FM - Micronesia, Federated States of
FO - Faroe Islands
FR - France
GA - Gabon
GB - United Kingdom
GD - Grenada
GE - Georgia
GF - French Guiana
GG - Guernsey
GH - Ghana
GI - Gibraltar
GL - Greenland
GM - Gambia
GN - Guinea
GP - Guadeloupe
GQ - Equatorial Guinea
GR - Greece
GS - South Georgia and the South Sandwich Islands
GT - Guatemala
GU - Guam
GW - Guinea-Bissau
GY - Guyana
HK - Hong Kong
HM - Heard Island and McDonald Islands
HN - Honduras
HR - Croatia
HT - Haiti
HU - Hungary
ID - Indonesia
IE - Ireland
IL - Israel
IM - Isle of Man
IN - India
IO - British Indian Ocean Territory
IS - Iceland
IT - Italy
JE - Jersey
JM - Jamaica
JO - Jordan
JP - Japan
KE - Kenya
KG - Kyrgyzstan
KH - Cambodia
KI - Kiribati
KM - Comoros
KN - Saint Kitts and Nevis
KR - Korea, Republic of (South)
KW - Kuwait
KY - Cayman Islands
KZ - Kazakhstan
LA - Laos
LB - Lebanon
LC - Saint Lucia
LI - Liechtenstein
LK - Sri Lanka
LR - Liberia
LS - Lesotho
LT - Lithuania
LU - Luxembourg
LV - Latvia
MA - Morocco
MC - Monaco
MD - Moldova
ME - Montenegro
MF - Saint Martin
MG - Madagascar
MH - Marshall Islands
MK - Macedonia, Republic of
MM - Myanmar
MN - Mongolia
MO - Macau
MP - Northern Mariana Islands
MQ - Martinique
MR - Mauritania
MS - Montserrat
MT - Malta
MU - Mauritius
MV - Maldives
MW - Malawi
MX - Mexico
MY - Malaysia
MZ - Mozambique
NA - Namibia
NC - New Caledonia
NE - Niger
NF - Norfolk Island
NG - Nigeria
NI - Nicaragua
NL - Netherlands
NO - Norway
NP - Nepal
NR - Nauru
NU - Niue
NZ - New Zealand
OM - Oman
PA - Panama
PE - Peru
PF - French Polynesia
PG - Papua New Guinea
PH - Philippines
PK - Pakistan
PL - Poland
PM - Saint Pierre and Miquelon
PN - Pitcairn
PR - Puerto Rico
PT - Portugal
PW - Palau
PY - Paraguay
QA - Qatar
RE - Reunion
RO - Romania
RS - Serbia
RU - Russia
RW - Rwanda
SA - Saudi Arabia
SB - Solomon Islands
SC - Seychelles
SE - Sweden
SG - Singapore
SH - Saint Helena, Ascension and Tristan da Cunha
SI - Slovenia
SJ - Svalbard and Jan Mayen
SK - Slovakia
SL - Sierra Leone
SM - San Marino
SN - Senegal
SR - Suriname
ST - Sao Tome and Principe
SV - El Salvador
SX - Sint Maarten
SZ - Swaziland
TC - Turks and Caicos Islands
TF - French Southern Territories
TG - Togo
TH - Thailand
TJ - Tajikistan
TK - Tokelau
TL - Timor-Leste
TM - Turkmenistan
TN - Tunisia
TO - Tonga
TR - Turkey
TT - Trinidad and Tobago
TV - Tuvalu
TW - Taiwan
TZ - Tanzania
UG - Uganda
UM - United States Minor Outlying Islands
US - United States of America
UY - Uruguay
VC - Saint Vincent and the Grenadines
VG - British Virgin Islands
VN - Vietnam
VU - Vanuatu
WF - Wallis and Futuna
WS - Samoa
YT - Mayotte
ZA - South Africa
ZM - Zambia
ZW - Zimbabwe


this is the list that i have fetched from the api for the country Djibouti.

